



NO ../maps/eren.xpm
WE ./path_to_the_west_texture
SO ./path_to_the_south_texture
EA ./path_to_the_east_texture


C               103,193,202
F 177,179,178

1
1N11
1111