
                    NO ../maps/eren.xpm

   WE ./path_to_the_west_texture
                    SO ./path_to_the_south_texture
C 103,193,202
EA ./path_to_the_east_texture

F 177,179,178










        11111111111111111111111111
        10000000001100000000000101
        1011000001110000000000001
        1001000000000000000000001
111111111011000001110000000000001
100000000011000001110111100011111
11110111111111011100000010001
11110111111111011101010111011
11000000110101011100000010001
10000000000000001100000010001
1000000000000000110101010S011
110000011101010111110111100111
11110111 1110101 101111010001
11111111 1111111 111111111111
11111111111111111111111111111
111
11
1
                 1




