NO xpms/1p.xpm
SO xpms/2p.xpm
WE xpms/3p.xpm
EA xpms/4p.xpm

F 211,211,211
C 204,255,255
                                    1111111111111111111111111
                                    1000000000110000000000001
                                    1011000001110000000000001
                                    1001000000000000000000001
111111111111111111111111111111111111110000001101010111000011
1000000000000000110000001000111000000110101011100000010001
1000000000000000110101001000111000000110101011100000010001
1111011111111101110000001000111000000110101011100000010001
1000000000000000110000001000111000000110101011100000010001
1000000000000000110000001000111000000110101011100000010001
1000000000000000110101001000111000000110101011100000010001
1000000000000000110101001000000000000110101011100000010001
1000000000000000110000001000111000000110101011100000010001
1100000011010101110000001000111000000110101011100000010001
1000000000000000110000001000110000000000000001100000010001
10000000000000001101010010001111111111111111111111111111111
11000001110101011111011110N0111
11110111 1110101 101111010001
11111111 1111111 111111111111