NO ./path_to_the_north_texture

SO     ./path_to_the_south_texture

WE            ./path_to_the_west_texture

EA    ./path_to_the_east_texture

F     220,100,10
C 225,30,0
                        11111111111111111 11111111         1
                        1111111111111111111111111
                        1000000000110000000000001
                        1000000000110000000000001
                        100000000011000000000000011
                        1000000000110000000000001
                        1000000000110000000000001
                        1000000000110000000000001
                        111111111111111111111111
                        111111111111111111111111
                        1000000000110000000000001
                        1000000000110000000000001
                        1000000000110000000000001
                        1000000000110000000000001
                        1000000000110000000000001
                        1000000000110000000000001
                        1000000000110000000000001
                        1000000000110000000000001
                        1000000000110000000000001
                        1000000000110000000000001
                        1000000000110000000000001
                        1000000000110000000000001
                        1000000000110000000000001
                        1000000000110000000000001
                        1000000000110000000000001
                        1011000001110000000000001
                        1001000000000000000000001
                111111111011000001110000000000001
                10000000001100000111011111111111
                111101111111110111001 1000100011
                11110111101 1111011101010010001
                110000001101010111000000100011
                1000000000000000110000001001
                10000000000000001101010010001
                11000001110101011111011110N0111
                11110111 1110101 10111101001
                11111111 1111111 1111111111
                                                          1
                                                         101
                                                          1
             1    1
1